farest_future	KEYWORD2
pulse	KEYWORD1
time	KEYWORD1
Pulses	KEYWORD1
~Pulses	KEYWORD2
pulse_t	KEYWORD1
init_time	KEYWORD2
get_now	KEYWORD2
add_time	KEYWORD2
sub_time	KEYWORD2
mul_time	KEYWORD2
div_time	KEYWORD2
multiply_period	KEYWORD2
divide_period	KEYWORD2
global_shift	KEYWORD2
start_pulse	KEYWORD2
stop_pulse	KEYWORD2
global_octave	KEYWORD2
global_octave_mask	KEYWORD2
current_global_octave_mask	KEYWORD2
now	KEYWORD2
last_now	KEYWORD2
global_next	KEYWORD2
global_next_count	KEYWORD2
init_pulse	KEYWORD2
init_pulses	KEYWORD2
wake_pulse	KEYWORD2
fix_global_next	KEYWORD2
setup_pulse	KEYWORD2
set_new_period	KEYWORD2
check_maybe_do	KEYWORD2
activate_pulse_synced	KEYWORD2
setup_pulse_synced	KEYWORD2
get_pl_max	KEYWORD2
pulse	KEYWORD2
pl_max	KEYWORD2
pulses	KEYWORD2
global_next_pulses	KEYWORD2
F	KEYWORD2
