Inputs	KEYWORD1
~Inputs	KEYWORD2
ioP_t	KEYWORD1
ioV_t	KEYWORD1
input_t	KEYWORD1
setup_sample_method	KEYWORD2
setup_in2o_custom	KEYWORD2
sample	KEYWORD2
oversamples_average	KEYWORD2
setup_raw	KEYWORD2
setup_linear	KEYWORD2
in2o_calculation	KEYWORD2
get_inputs_allocated	KEYWORD2
get_counter	KEYWORD2
sample_and_react	KEYWORD2
setup_io_reaction	KEYWORD2
get_last_sampled	KEYWORD2
inputs_allocated	KEYWORD2
inputs	KEYWORD2
get_counter	KEYWORD2
get_flags	KEYWORD2
get_input_addr	KEYWORD2
get_input_p2	KEYWORD2
get_oversampling	KEYWORD2
get_input_offset	KEYWORD2
get_mul	KEYWORD2
get_div	KEYWORD2
get_output_offset	KEYWORD2
get_output_addr	KEYWORD2
